enhance	提高，加强
enhancement	增加，放大
revisit	重游，再访
revise	修订
category	目录
impact	影响
approach	途径，方法
convenient	便利的
convention	惯例，约定，习俗
consist	由...组成，符合
consistent	一致的
straightforward 简单的，坦率的，直截了当地
stuff	东西，材料
properly	正确地，恰当地
undermine	破坏
entire	全部的，整个的，整体的
defect	瑕疵
huge	巨大的
definitely	清楚的
persistent	持久的
benefit	利益，好处
incorporate	包含
technique	技巧
reusable	可重复使用的
distinct	独特的，有区别的
demand	需要
violation	违反，违规
problematic	有疑问的，有问题的
sense	感觉，感觉到
branding	品牌，品牌化
emphasis	重点
alternative	供选择的
variation	变化
limitation	局限性
duplicate	复制，重复
verify	核实，查证
individual	个人，个人的
ecommerce	电子商务
sophisticated	复杂的，精致的
fundamental	基本原理，基本原则，基本的
essential	基本的
consise	简明的
blurry	模糊的，不清楚的
surrounding	周围的，附件的
appropriate	合适的
additional	附加的，额外的
additionally	此外
concept	概念，观念
notion	概念
likewise	同样，也
guarantee	保证，担保
consider	考虑
advantage	优势，特点
considerably	相当地，非常地
result in	导致
varying	不同的，变化的
sufficient	足够的，充分的
various	各种各样的
elegantly	优美地
particular	个别的
capability	能力
accompany	伴随
conserve	保存
misleading	误导
consume	消耗
amount	数量，总额，总数
scalable	可扩展的
rationale	基本原理


